11,08
      XXXXX
      XG  X
      XGX X
XXXXXXXGX X
X R B B B X
X X X X XXX
X       X  
XXXXXXXXX  
