06,08
XXXXX 
XG  XX
XRBB X
XX   X
 XX  X
  XX X
   XGX
   XXX
