07,08
  XXXX 
  X  X 
XXXB XX
X B  RX
X GGG X
XXB  XX
 X  XX 
 XXXX  
