18,09
XXXX   XXXXXXXXXXX
XXXXB  XXXXXXXXXXX
XXXX  BXXXXXXXXXXX
XX  B B XXXXXXXXXX
XX X XX XXXXXXXXXX
   X XX XXXXX   GG
 B  B           GG
XXXX XXX XXRX   GG
XXXX     XXXXXXXXX
